1010017100101
1010011100101
1500003000051
1100111110011
0000172710000
1100117110011
1500000000051
1010011100101
1010017100101