111011101110111
150000000000051
101011111110101
101017777710101
101011111110101
100000000000001
001110111011100
101110121011101
001110171011100
100000000000001
101011111110101
101017777710101
101011111110101
150000030000051
111011101110111