110000000010010000017771000000
000000010010010000011111000000
000000010011111000000000000000
110000010000000000000010001111
710000010000000011110010000177
110001111100000017710010001111
000001777111000011110000000000
000001777100000000003000010000
101101111100011000011110010000
101001000000177100017710010011
101001000000011000017710011001
101111000111000000017710010001
100000000171011100011110010001
100011100111000100000000011111
100001000000000000000000000000
100000000011111100001001110000
100001110017277700001000000100
000001710011111100001111100100
000001110000011000001777100000