11111011111177777111111011111
10001010000111111100001010001
11101010000000000000001010111
77100000000011111000000000177
11101111010017771000111100111
10001000010011111001177110001
10001011110000000000111100001
11100000000011711001177110111
00000011110017271000111100000
11100117711011111000000000111
10000011110000000001111010001
10000117711011111001000010001
11100011110017771001011110111
77100000000011111000000000177
11101010000000300000001010111
10001010000111111100001010001
11111011111177777111111011111